Unidad 2
Seite 187 rechts
la calle - die Straße, el amigo - der Freund, la amiga - die Freundin, el profesor - der Lehrer, la profesora - die Lehrerin, el bar - die Kneipe, el taxi - das Taxi, el animal - das Tier, el mundo - die Welt, mi - mein, la ciudad - die Stadt, el padre - der Papa, la madre - die Mama, los padres - die Eltern, el hermano - der Bruder, la hermana - die Schwester, los hermanos - die Geschwister, el mejor amigo - der beste Freund, la mejor amiga - die beste Freundin 

Seite 188 links
la mascota - das Haustier, el abuelo - der Großvater, die Großmutter - la abuela, spanisch - español, el tío - der Onkel, se llama - er heißt, él tiene - er hat, sí - ja, no - nein, la familia - die Familie, el acento - der Akzent, el punto - der Punkt, se escribe - man schreibt, ¿quién? - wer?, ¿qué - was?, ser - sein

Seite 188 rechts
él - er, ella - sie, nosotros - wir, vosotros - ihr, el Internet - das Internet, Austria - Österreich, más - mehr, mis - meine, hablar - sprechen, el novio - der feste Freund, la novia - die feste Freundin, el hijo - der Sohn, el médico - der Arzt, la médica - die Ärztin, trabajar - arbeiten



Seite 189 links
hablar por teléfono - telefonieren, todos los días - jeden Tag, el verano - der Sommer, pasar - verbringen, las vacaciones - die Ferien, el nombre - der Name, el instituto - die Schule, el actor - der Schauspieler, la actriz - die Schauspielerin, el perro - der Hund, genial - genial, Ciudad de México - Mexiko Stadt, estudiar - lernen, Estados Unidos - USA, el idioma - die Sprache, el inglés - Englisch, el alemán - Deutsch, ¿qué idiomas hablas - welche Sprachen sprichst du?

Seite 189 rechts
la Foto - das Foto, la persona - die Person, hablar - sprechen, sus - seine, tus - deine, el fin de semana - das Wochenende, el fin - das Ende, la semana - die Woche, los alpes - die Alpen, tener - haben, allí - dort, el helado - das Eis, tener hambre - Hunger haben, después de - danach, la bici - das Fahrrad, la excursión - der Ausflug, en bicicleta - mit dem Fahrrad 

Seite 190 links
el primo - der Cousin, la prima - die Cousine, ¿por qué? - warum?, preguntar - fragen, lo siento - Entschuldigung, como - wie, el horror - der Horror, el enemigo - der Feind, tener gracia - lustig sein, 


WWW Unidad 2
la calle - die Straße
el amigo - der Freund
la amiga - die Freundin
el profesor - der Lehrer
la profesora - die Lehrerin
el bar - die Kneipe
el taxi - das Taxi
el animal - das Tier
el mundo - die Welt
la ciudad - die Stadt
el padre - der Papa
la madre - die Mama
los padres - die Eltern
el hermano - der Bruder
la hermana - die Schwester
los hermanos - die Geschwister
el abuelo - der Großvater
la abuela - die Großmutter
el tío - der Onkel
la familia - die Familie
sí - ja
no - nein
él - er
ella - sie
hablar - sprechen
trabajar - arbeiten
todos los días - jeden Tag
el verano - der Sommer
las vacaciones - die Ferien
el idioma - die Sprache






Unidad 3


Seite 190 rechts
el metro - die U-Bahn, el cine - das Kino, la biblioteca - die Bibliothek, la panadería - die Bäckerei, el Centro comercial - das Einkaufszentrum, el parque - der Park, la cafetaría - das Café, el restaurante - das Restaurant, hay - es gibt, el piso - die Wohnung, la habitación - das Zimmer, el baño - das Badezimmer, la cocina - die Küche, el salón - das Wohnzimmer

Seite 190 links
el barrio - das Stadtviertel, el museo - das Museum, la farmacia - die Apotheke, la parada de metro - U-Bahn-Station, la parada - die Haltestelle


Seite 191 links
el balcón - der Balkon, el pasillo - der Flur, el dormitorio - das Schlafzimmer, la mudanza - der Umzug, la vecina - die Nachbarin, raro,-a - komisch, estar - sich befinden, fatal - sehr schlecht, ya - schon, bonito, -a - schön, pequeño, -a - klein, grande - groß

Seite 191 rechts
además - außerdem, todo - alles, ahora mismo - sofort,el desastre - die Katastrophe, poco, -a - wenig, el mueble - das Möbelstück, pues - also, cerca de - in der Nähe von, al lado de - neben, famoso ,-a - berühmt, lo mejor - das Beste, no sé - ich weiß nicht

Seite 192 rechts
gracioso, -a - lustig, quedar - sich verabreden, esta tarde - heute Nachmittag, vale - einverstanden, vivir - wohnen, primero - erster, la cama - das Bett, la mesa - der Tisch, el armario - der Schrank, el ordenador - der Computer, la puerta - die Tür

Seite 192 links
normal - normal, loco, -a - verrückt, por la noche - nachts, escuchar - hören, mucho, -a - viel, el ruido - das Geräusch, a veces - manchmal, su - sein, hablar solo - ein Selbstgespräch führen, solo, -a - allein, el miedo - die Angst, la serie - die Fernsehserie, estar - sich befinden, hoy - heute, a lo mejor - vielleicht, simpático, -a - sympathisch

Seite 193 links
la silla -der Stuhl, debajo de - unter, encima de - auf, detrás de - hinter, entre - zwischen, delante de - vor, a la derecha de - rechts von, a la izquierda de - links von, el Señor - der Herr, interesante - interessant, moderno, -a - modern, lejos de - weit entfernt, el paseo - der Spaziergang, preparar - vorbereiten, algo - etwas


Seite 193 rechts
por eso - deshalb, el centro histórico - die Altstadt,  mirar - schauen, la guía - der Reiseführer, sobre - über, el kilómetro - der Kilometer, tomar - trinken, ir - gehen, todo recto - geradeaus, voy - ich gehe, vas - du gehst, va - er geht, vamos - wir gehen, vais - ihr geht, van - sie gehen, el teatro - das Theater, importante - wichtig, el jardín - der Garten, el palacio - der Palast, desde - von, girar - abbiegen, antiguo, -a - alt, al final - zum Schluss

Seite 194 links
aquí - hier, terminar - beenden, la comida - das Essen, típico, -a - typisch, el calamar - der Tintenfisch, el churro - Churro, el chocolate - die Schokolade, rico, -a - reich, el conesjo - der Ratschlag, la línea - die Linie, 




WWW  Unidad 3
el metro - die U-Bahn
el cine - das Kino
la biblioteca - die Bibliothek
la panadería - die Bäckerei
el centro comercial - das Einkaufszentrum
el parque - der Park
el restaurante - das Restaurant
el piso - die Wohnung
la habitación - das Zimmer
el baño - das Badezimmer
la cocina - die Küche
el salón - das Wohnzimmer
el barrio - das Stadtviertel
el museo - das Museum
la farmacia - die Apotheke
el balcón - der Balkon
el dormitorio - das Schlafzimmer
la vecina - die Nachbarin
bonito, -a - schön
pequeño, -a - klein
grande - groß
cerca de - in der Nähe von
al lado de - neben
vivir - wohnen
la cama - das Bett
la mesa - der Tisch
el armario - der Schrank
la puerta - die Tür
el ruido - das Geräusch
escuchar - hören







Unidad 4
Seite 194 links 
a - nach, hin, el tiempo libre - die Freizeit, el tiempo - die Zeit, libre - frei

Seite 194 rechts
chatear - chatten, ir de compras - einkaufen gehen, montar en bici - Fahrrad fahren, la música - die Musik, escalar - klettern, descansar - sich ausruhen, el libro - das Buch, leer - lesen, hacer - machen, el deporte - der Sport, hacer deporte - Sport machen, ver - sehen, la tele - das Fernsehen, visitar - besuchen, me gusta - mir gefällt

Seite 195 rehts
favorito, -a - lieblings-, siempre - immer, por la tarde - am Nachmittag, el cómic - der Comic, tocar - spielen (Instrument), la guitarra - die Gitarre, vago - faul, porque - weil,el miércoles - Mittwoch, la película - der Film, correr - rennen, el partido de fútbol - das Fußballspiel, el partido - das Spiel 

Seite 195 links
gustar - gefallen, a mí también - mir auch, a mí no - mir nicht, la encuesta - die Umfrage, necesitar - brauchen, la ayuda - die Hilfe, para - für, los deberes - die Hausaufgaben, la pregunta - die Frage,  cuándo - wann, normalmente - normalerweise, el minuto - die Minute, cuál - welcher

Seite 196 rechts
 la actividad - die Aktivität, vivir - wohnen, casi - fast, a la semana - pro Woche, el plan - der Plan, en punto - Punkt..., y - und, menos - vor (Uhrzeit), un cuarto - ein Viertel, el dibujo - die Zeichnung, de la mañana - morgens, de la tarde - nachmittags, de la noche - nachts



Seite 196 links
el fútbol - der Fußball, menos - außer, escribir - schreiben, algo - etwas, tampoco - auch nicht, para mi - für mich, la clase - der Unterricht, o - oder, la piscina - das Schwimmbad, tomar el sol - sich sonnen, el programa - das Fernsehprogramm, gracias - danke, por la mañana - morgens

Seite 197 rechts
el cumpleaños - der Geburtstag, nos vemos - bis bald, comprar - kaufen, el regalo - das Geschenk, después - danach, jugar - spielen, jugar al baloncesto - Basketball spielen, jugar al fútbol - Fußball spielen, el baloncesto - der Basketball, perfecto - perfekt, el día a día - der Alltag, el Patio - der Hof


Seite 197 links
recibir - empfangen, el mensaje - die Nachricht, cuidar de - kümmern um, poder - können, tener ganas - Lust haben, querer - wollen, el zoo - der Zoo, estar castigado sin salir - Hausarrest haben, el besito - das Küsschen, de - von, a - bis, la sorpresa - die Überraschung, la entrada - die Eintrittskarte, 

WWW Unidad 4
el tiempo libre - die Freizeit
chatear - chatten
ir de compras - einkaufen gehen
descansar - sich ausruhen
el libro - das Buch
leer - lesen
hacer - machen
el deporte - der Sport
ver - sehen
visitar - besuchen
siempre - immer
por la tarde - am Nachmittag
la película - der Film
correr - rennen
gustar - gefallen
necesitar - brauchen
la ayuda - die Hilfe
para - für
los deberes - die Hausaufgaben
cuándo - wann
normalmente - normalerweise
la actividad - die Aktivität
vivir - wohnen
el plan - der Plan
escribir - schreiben
la clase - der Unterricht
o - oder
comprar - kaufen
después - danach
querer - wollen




Unidad 5
Seite 198 rechts
el alumno - der Schüler, la alumna - die Schülerin, el e-Mail - die Email, el horario - der Stundenplan, la asignatura - das Fach, las Matemáticas - Mathe, la Música - Musik, la Geografía e Historia - Geschichte, el Francés - Französisch, la Educación Física - Sport, el Inglés - Englisch, la Lengua Castellana y Literatura - Spanisch, la lengua - die Sprache, 



Seite 198 links
el aula - der Klassenraum, el aula die informática - der Informatikraum, la secretaría - das Sekretariat, la informática - Informatik, el gimnasio - die Sporthalle, la mochila - der Rucksack, la carpeta - der Ordner, el bolígrafo - der Kugelschreiber, la goma - das Radiergummi, el portátil - der Laptop, la tableta - das Tablet, el lápiz - der Bleistift, el cuaderno - das Heft, el estuche - das Mäppchen, la calculadora - der Taschenrechner, cuántos - wie viele

Seite 199 links
el castellano - spanisch, la literatura - Literatur, el recreo - die Pause, la Expresión Plástica - Kunst, tener mala cara - schlecht aussehen, malo, -a - schlecht, la cara - das Gesicht, buscar - suchen, encontrar - finden, alguien - jemand, llamar - anrufen, poner en silencio - leise stellen, el silencio - die Ruhe, tranquilo, -a - ruhig


Seite 199 rechts 
pensar - denken, mirar - schauen, creer - glauben, que - dass, copiar - kopieren, meter - hinlegen, desde - seit, rojo, -a - rot, tonto, -a - dumm, entonces - dann, la nota - die Note, la carta - der Brief, el amor - die Liebe

WWW Unidad 5
el aula - der Klassenraum
la secretaría - das Sekretariat
la informática - Informatik
el gimnasio - die Sporthalle
la mochila - der Rucksack
la carpeta - der Ordner
el bolígrafo - der Kugelschreiber
la goma - das Radiergummi
el portátil - der Laptop
el lápiz - der Bleistift
el cuaderno - das Heft
el estuche - das Mäppchen
la calculadora - der Taschenrechner
cuántos - wie viele
el castellano - Spanisch
la literatura - Literatur
el recreo - die Pause
tener mala cara - schlecht aussehen
malo, -a - schlecht
la cara - das Gesicht
buscar - suchen
encontrar - finden
alguien - jemand
llamar - anrufen
poner en silencio - leise stellen
el silencio - die Ruhe
pensar - denken
mirar - schauen
creer - glauben
que - dass










Unidad 6 
Seite 200 rechts
dormir - schlafen, relajarse - sich ausruhen, tomar - trinken, la mierenda - der Snack, irse- weggehen, levantarse - aufstehen, la leche - die Milch, la galleta - der Keks, la fruta - das Obst

Seite 200 links
nuestro - unser, el secreto -das Geheimnis, perder - verlieren, vuestro - euer, quedarse - bleiben, lavarse - sich waschen, cepillarse los dientes - sich die zähne putzen, el diente - der Zahn, antes de - bevor, ducharse - sich duschen, el agua - das Wasser, frío, -a - kalt, ponerse - sich anziehen, el pijama - der Schlafanzug 

Seite 201 links
salir - ausgehen, la idea - die Idee, estupendo, -a - toll, estar contento - zufrieden sein, el extranjero - das Ausland, ir de viaje - verreisen, el viaje - die Reise, viajar - reisen, por - wegen, bueno - gut, guay - gut, bienvenido - willkommen, primero - zuerst, el país - das Land, fantástico, -a - fantastisch, juntos - zusammen

Seite 201 rechts
pelearse - sich streiten, la visita - der Besuch, acabar de - etwas gerade getan haben, tardar - brauchen, mañana - morgen, el examen - die Klassenarbeit, la suerte - das Glück, temprano - früh, mucho - viel, el pie - der Fuß, a pie - zu Fuß, estar de acuerdo - einverstanden sein 

Seite 202 links
empezar - anfangen, la Navidad - Weihnachten, el curso - der Kurs, celebrar - feiern, organizar - organisieren, la información - die Information, el lugar - der Platz, si - wenn, el dinero - das Geld


Seite 203 links
decorar - dekorieren, necesario,-a - notwendig, la canción - das Lied, el juego - das Spiel, divertido, -a - lustig, hay que - man muss, el aceite - das Öl, la pimienta - der Pfeffer, la cebolla - die Zwiebel, la sal - das Salz, el huevo - das Ei, la lechuga - der Salat, el pimiento - die Paprika, la carne - das Fleisch

Seite 203 rechts
el tomate - die Tomate, el azúcar - der Zucker, el ajo - Knoblauch, el plátano - die Banane, la tortilla - die Tortilla, la lista de compra - die Einkaufsliste, medio - halb, el litro - der Liter, la lata - die Dose, el paquete - das Paket, la botella - die Flasche, la bolsa - die Tüte, costar - kosten

Seite 204rchts
el problema - das Problem, el suelo - der Boden, la pizza - die Pizza, el salami - die Salami, traer - bringen, rápido, -a - schnell, pedir - bestellen, otro, -a - ein anderer, la verdura - das Gemüse, el camarero - der Kellner

Seite 204 links
el euro - der Euro, el céntimo - der Cent, ayudar - helfen, a ver... - lass mal sehen, mejor - besser, llevar - mitbringen, el ingrediente - die Zutat, diferente - verschieden, llegar - ankommen, feliz - glücklich, desear - wünschen, todos, -as - alle, contar - erzählen

Seite 205 links
sin - ohne, por favor - bitte, en vez de - statt, esperar - warten, preferir - bevorzugen, el maíz - der Mais, perdón - Entschuldigung, la aceituna - die Olive, echar - hinzugeben, demasiado - zu viel, el extra - das Extra, el queso - der Käse, el postre - der Nachtisch, la tarta - der Kuchen

Seite 205 rechts
el frigorífico - der Kühlschrank, beber - trinken, nada - nichts, nadie - niemand, un poco de - ein bisschen, estar enfadado,-a - verärgert sein, ¿Cuánto es? - Wie viel kostet das?, la dirección - die Adresse, la cuenta - die Rechnung, pagar - bezahlen, el orégano - Oregano, el chile - die Chilli, el jamón - der Schinken, especial - besonders, el tirmaisú - das Tiramisu

Seite 206 links
el refresco - der Drink, salado, -a - salzig, soso, -a - ungesalzen, el plato - der Teller, el segundo plato - das Hauptgericht



Wirklich Wichtige Wörter (WWW) Unidad 6: 
dormir - schlafen
relajarse - sich ausruhen
tomar - trinken
irse - weggehen
levantarse - aufstehen
la leche - die Milch
nuestro - unser
perder - verlieren
quedarse - bleiben
lavarse - sich waschen
ducharse - sich duschen
el agua - das Wasser
ponerse - sich anziehen
salir - ausgehen
estar contento - zufrieden sein
bueno - gut
mañana - morgen
mucho - viel
empezar - anfangen
si - wenn
el dinero - das Geld
necesario,-a - notwendig
divertido, -a - lustig
hay que - man muss
la sal - das Salz
el huevo - das Ei
el problema - das Problem
traer - bringen
rápido, -a - schnell
pedir - bestellen



Unidad 7
Seite 206 rechts
un millón - eine Million, el habitante - der Einwohner la capital - die Hauptstadt, la frontera - die Grenze, los EEUU - die USA, el río - der Fluss,  montaña - der Berg, alto, -a - hoch, el volcán - der Berg, el metro - der Meter, el bosque - der Wald, el pájaro - der Vogel, Independiente - unabhängig, la pirámide - die Pyramide, la diferencia - der Unterschied, a partir de - ab


Seite 207 links
organizado, -a - organisiert, el billete - das Ticket, el avión - das Flugzeug, venir - kommen, conmigo - mit mir, el turismo - der Tourismus, significar - bedeuten, aprender - lernen, contigo - mit dir, recomendar - empfehlen, el grupo - die Gruppe, el cañón - der Canyon, impresionante - beeindruckend

Seite 207 rechts
más - mehr, el tren - der Zug, turístico,-a - touristisch, la zona - die Zone, el helicóptero - der Helikopter, el norte - der Norden, el guía - der Reiseführer, el coche - das Auto, el autobús - der Bus, el turista - der Tourist, el globo - der Luftballon, barato, -a - billig, bucear - schnorcheln

Seite 208 links
la gente - die Menschen, el sur - der Süden, el este - der Osten, el oeste - der Westen, el norte - der Norden, el medio de transporte - das Transportmittel, lento, -a - langsam, caro, -a - teuer, viejo, -a - alt, tan... como... - so... wie..., oficial - offiziell, el tiempo - das Wetter, hace sol - die Sonne scheint, el sol - die Sonne, el viento - der Wind, nevar - schneien

Seite 208 rechts
está nublado - es ist bewölkt, hay niebla - es ist neblig, hace 10 grados - es sind 10 Grad, el grado - Grad, hace calor - es ist warm, bajo cero - unter Null, hace frío - es ist kalt, ayer - gestern, la aventura - das Abenteuer, el destino - das Ziel, varios, -as - verschiedene, acompañar - begleiten, el fotógrafo - der Fotograf, el tiburón - der Hai, la ruta - die Route

Seite 209 links
maya - Maya, el camino - der Weg, alquilar - mieten, parar - anhalten, cuando - als, la gasolina - das Benzin, quedarse sin - jemandem ausgehen, la gasolinera - die Tankstelle, volver - zurückkommen, montar a caballo - reiten, el niño - das Kind, el burro - der Esel, el pueblo - das Dorf, prestar - leihen, el bañador - der Badeanzug, todo el día - den ganzen Tag



WWW Unidad 7

un millón - eine Million
el habitante - der Einwohner
la capital - die Hauptstadt
la frontera - die Grenze
los EEUU - die USA
el río - der Fluss
la montaña - der Berg
el volcán - der Vulkan
el bosque - der Wald
el pájaro - der Vogel
el billete - das Ticket
el avión - das Flugzeug
el turismo - der Tourismus
aprender - lernen
recomendar - empfehlen
el tren - der Zug
el coche - das Auto
el autobús - der Bus
la gente - die Menschen
el norte - der Norden
el sur - der Süden
el este - der Osten
el oeste - der Westen
el medio de transporte - das Transportmittel
el tiempo - das Wetter
hace sol - die Sonne scheint
está nublado - es ist bewölkt
hace calor - es ist warm
el camino - der Weg
la gasolinera - die Tankstelle




Unidad 8


Seite 209 rechts
el dolor - der Schmerz, la barriga - der Bauch, enfadarse - ich aufregen, moverse - sich bewegen, la ropa - die Kleidung, próximo - nächster, el estilo - der Stil, la maleta - der Koffer, el mismo - derselbe, pasado, -a - vergangener, mal - schlecht, nadar - schwimmen, hacer surf - surfen, hacer senderismo - wandern, durante - während, 

Seite 210



